********
*   * **
*     $*
*    $ *
*   O$**
*  *   *
**  P  *
********