********
* *    *
* $ B  *
*$P*  P*
* ** $ *
*   *  *
*    * *
********