********
*   $ **
**     *
*   $  *
**  *  *
*   P  *
**  $ **
********