********
*  $   *
* *  P**
*  P ***
*    $B*
* $**  *
*   *  *
********