********
*     **
* * $$ *
*      *
*  *  **
*P $*  *
*PB   **
********