********
**P  * *
**    **
*   $  *
* *   $*
**   $ *
*     P*
********