********
*  $* **
*   P  *
*    $ *
*O *   *
*      *
*    *$*
********