********
***  * *
*  *  $*
*$PP   *
*      *
*   $  *
** * * *
********