********
* P    *
*P  **$*
*    $**
*   * **
** $ * *
* B    *
********