********
*      *
** $$  *
*  P * *
*  **  *
*      *
*      *
********