**********
*  O*    *
*  * *   *
* * B    *
*     $  *
*   * ** *
* $*   * *
*      $ *
* *  *   *
**********