**********
*  *   * *
*$       *
*        *
* *$     *
*   *    *
** B *   *
*$       *
*  P***  *
**********