**********
*       **
*    O*P *
*      ***
*    *   *
*     ****
** *     *
*$$$     *
* ** *   *
**********