**********
*  *  $  *
*    * $ *
*   * * **
*  O   B *
*      * *
*   * * $*
*   *   **
*  *    **
**********