0.8 0.1 0.1
6 7
2
3 3 -10
3 4 10
-0.01
*******
*     *
* *** *
*     *
*     *
*******
